#######################
#                     #
#  *  #         #  *  #
#  #      #        #  #
#                     #
#   ####      #       #
#    #               ##
#   *       #         #
#   #              #  #
#   #      #      *   #
# #               #   #
#    # ###   ####     #
#                *    #
#   #         #  ##   #
#          #          #
#  *    #        *    #
#  ###          ####  #
#$            *       #
#######################