#######################
#                     #
# *   #       #       #
# #               #   #
#     #     *         #
#           #       * #
#        *      #   # #
#   #    #     *      #
#              #      #
#      #              #
#                     #
#   *      #    #     #
#   #                 #
#            #        #
#       *             #
#  *    #        *    #
#  ###          ####  #
#$            *       #
#######################