#######################
#                     #
#                     #
#                     #
#                     #
#                     #
#                     #
#                     #
#                     #
#                     #
#                     #
#                     #
#                     #
#                     #
#                     #
#                     #
#                     #
#$                    #
#######################